###@###@###
#..,./.,..#
#..,./.,..#
#..,./.,..#
###<###>###